                                                    :::::::::::::::::::::::::::::::::::::::::::::::::::                      ::::            :::                           :::                                                   
                                      :: :::  :::::::::::::::::::    ::::::::::::::::::::::::::::::::                  :::::::::::           :::                         ::::::::::                                              
                                  :::::::::::::  ::::::::::::::           :::::::::::::::::::::::::::                     ::                       ::::::             ::::::::::::::::::              :::::::::                  
::           :::::                ::::::::::::::::::::: ::::::::::::          :::::::::::::::::::::                            ::::              ::::     ::::::::::::::::::::::::::::::::::::::::::::::::::::::::::            :
::       :::::::::::::::::::::::::::::::::::::::::::::::::::::  ::::::::       ::::::::::::::::::                        :::::::::::::::::  : :::::::::::::::::::::::::::::::::::::::::::::::::::::::::::::::::::::::::::::::::::
::::::: :::::::::::::::::::::::::::::::::::::::::::::::::::::: :::::::::::    ::::::::::::       :::::::               ::::::::::::::::::::::::::::::::::::::::::::::::::::::::::::::::::::::::::::::::::::::::::::::::::::::::::
   ::::: :::::::::::::::::::::::::::::::::::::::::::::::  :::::::::::::::       ::::::            ::::             ::::::::: ::::::::::::::::::::::::::::::::::::::::::::::::::::::::::::::::::::::::::::::::::::::::::::::::::::
       ::: ::::::::      ::::::::::::::::::::::::::::::         ::::::::::        ::::                       ::    ::::::::::  ::::::::::::::::::::::::::::::::::::::::::::::::::::::::::::::::::::::::::::::::::  ::::          
          : ::  ::           ::::::::::::::::::::::::::::::::::::::::::::::::                              :::::     :::::::::::::::::::::M:::::::::::::::::::::::::::::::::::::::::::::::::::::::::::::         ::::::          
                             ::::::::::::::::::::::::::::::::: :::::::::::::::                            :::::::::::::::::::::::::::::::::::::::::::::::::::::::::::::::::::::::::::::::::::::::::::::::::      ::::            
                                :::::::::::::::::::::::::::::::::::::::::: :::::                             :::P::::::::::::::::::::::::::::::::::::::::::::::::::::::::::::::::::::::::::::::::::::::::::                      
                                  ::::::::::::::::::::::::::::::::::::::::::::::                               ::::::::::::::::::::::::::::::::: ::::::::::::::::::::::::::::::::::::::::::::::::::::::: ::                      
                                  ::::::::::::::::::::::::::::::::::N                                     :::::::::::::::::::::::::  ::  :::::: :::::::::::::::::::::::::::::::::::::::::::::::::::::  :::::                     
                                  :::::::::::::::::::::::::::::::::                                       :::::::    ::  :::::::::::::::::::::::  :::::::::::::::::::::::::::::::::::::::::::::::      :::                       
                                   :L:::::::::::::::::::::::::::::                                         ::::::::::::: ::  ::::::::::::::::::: ::::::::::::::::::::::::::::::::::::::::::::  ::: ::::::                        
                                      ::::::::::::::::::::::::::                                          :::::::::::::::::  ::::    ::::::::::::::::::::::::::::::::::::::::::::::::::::::::     ::::T                          
                                       :::::::::::::::::::::::                                            :::::::::::::::::::::::::::::::::::::::::::::::::::::::::::::::::::::::::::::::::::    ::                              
                                        ::::::::::::        :::::                                      ::::::::::::::::::::::::::::::::::::::::::::::::::::::::::::::::::::::::::::::::::::::                                    
                                          :: :::::::       ::::::                                     ::::::::::::::::::::::::::::::::::::::::::::::D:    ::::::::::::::::::::::::::::::::::S                                    
            ::::                              :::::::  ::::    ::: :::                               :::::::::::::::::::::::::::::::::::::::::::::::::     ::B:::::::::   ::::::::::::     :                                     
               :                                ::::::::::     ::  :: ::                              ::::::::::::::::::::::::::::::::::: ::::::::::          :::::::      :::::::::::     ::                                    
                                                      :::::::                                        :::::::::::::::::::::::::::::::::::::::::::               ::::          ::::::::      ::::                                  
                                                          :::    ::::::::::                           :::::::::::::::::::::::::::::::::::::::::::              ::::           :::::::     ::::::                                 
                                                             ::::::::::::::::                           ::::::Y:::::::::::::::::::::::::::::::::                ::::         ::::        ::  :::                                 
                                                                :::::::::::::::::                         ::: ::   ::::::::::::::::::::::::::::                   ::        ::::::     ::::   ::                                 
                                                              ::::::::::::::::::::                                    :::::::::::::::::::::::                                 ::::  ::::::::  : :                                
                                                             :::::::::::::::::::::::::::                             ::::::::::::::::::::::                                    ::::  ::::::::: ::::::::::      :                 
                                                             ::::::::::::::::::::::::::::::                            :::::::::::::::::::                                      ::::: :::: ::: :::: ::::::::: :: :               
                                                              :::::::::::::::::::::::::::::                             ::::::::::::::::::                                          :::::::::::     : ::::::::   :::::           
                                                               :::::::::::::::::::::::::::                              ::::::::::::::::::     :                                           : ::   :::::  :: :::     ::           
                                                                :::::::::::::::::::::::::                              :::::::::::::::::::  ::::                                              ::::::::: ::::            ::       
                                                                   ::::::::::::::::::::::                              :::::::::::::::::   :::::                                            ::::::::::::::::            ::     ::
                                                                    :::::::::::::::::R::                                :::::::::::::::    ::::                                        ::::::::::::::::::::::::        ::        
                                                                    ::::::::::::::::                                     ::::::::::J:::    ::::                                        ::::::::::::::::::::::::::                
                                                                   ::::::::::::::::                                       ::::::::::::                                                 ::::::::::::::::::::::::::                
                                                                   :::::::::::::::                                         :::::::::                                                    :::::::::::::::::::::::::                
                                                                   :::::::::::::                                           ::::::                                                       :::::::     :::::::::::C            ::   
                                                                  ::::::::::::                                                                                                                         ::::::::              ::::
                                                                  ::::::::                                                                                                                                ::::             ::::: 
                                                                  :::::::                                                                                                                                  ::            ::::    
                                                                 :::::::                                                                                                                                                 ::      
                                                                 ::::::   ::                                                                               ::                                                                    
                                                                 ::::::   :::                                                                                                                                                    
                                                                    ::::                                                                                                                                                         
